R 1120 720

S ../textures/barrel.xpm
NO ../textures/redbrick.xpm
SO ../textures/bluestone.xpm
WE ../textures/colorstone.xpm
EA ../textures/wood.xpm

C 60,225,243
F 237,127,16

111111111111111111111111
100000020001122000000001
100100000001122000011001
100110022011000001100001
100001111111111111100001
100000000001100000000001
111111110001100011111111
120000010001100010000001
111110010011110010011111
100000000001100000100001
1100110000W0110001100101
100210000000000010000111
10002100000000000010001
10002101100000011010011
100021021000000100122221
111111111110011111111111
100000000100001000002221
100020000000000000000021
100000000100001000002221
111111111110011111111111
122000000010010000000221
100001110000000011100001
122001110010010000000221
111111111111111111111111
